11111111011
1000P000111
11111110111