11111111111111
1000P000111111
10000000001111
1000000E001111
11111111111111