11111111111111111111111111111
10P00C00E10000000F01111111111
100000F0000000000000000000001
11111111111111111111111111111