11111111111111111111111111111111
10000000000000C00000000000000001
100000P0000000000000000000000001
100000000000000000000000E0000001
1000000000000C000000000000C00001
10000000000000000000000000000001
100000C0000000000000000000000001
10000000000000000000000C00000001
11111111111111111111111111111111