11111111111111111111111111111111
1000P000000000000000000000000001
10000000000000000000000000000001
10000000000000000000000000000001
10000000000000000000000000E00001
11111111111111111111111111111111