11111111111
100011000
110011111
1000000001
11111111111