11111111111111111111111111111
10P00C00E10000000001111111111
10000000000000000000000000001
11111111111111111111111111111