100000000001
111111111111
111111111111
100000000001